0,1,2,3,4,0,1,2,3,4,0,1,2,3,4,5,1,2,1,2,1,2,1,2,1,2,1,2,1,2,1,2
3,3,,,,,,,5,,,,,,,,,,,,,,,,,,,,,,,1
0,,3,,,,,,,,,,,,,,,,,,,,,,,,,,,,,2
1,3,,,,,,,,0,1,2,,,,,,,,,,,,,,,,,,,,1
2,0,,,,,,,,3,4,5,,,,,,,,,,,,,,,,,,,,2
1,5,,,,,,,,,,,,,,,,,,,,,,,,,,,,,,1
2,5,,,,,,,,,,,,,,,,,,,,,,,,,,,,,,2
1,4,,,,,,,,,,,,,,,,,,,,,,,,,,,,,,1
3,0,,,,,,,,,,,,,,,,,,,,,,,,,,,,,,2
1,4,,,,,,,,,,,,,,,,,,,,,,,,,,,,,,1
5,2,,,,,,,,,,,,,,,,,,,,,,,,,,,,,,2
1,,,,,,,,,,,,,,,,,,,,,,,,,,,,,,,1
0,,,,,,,,,,,,,,,,,,,,,,,,,,,,,,,2
1,,,,,,,,,,,,,,,,,,,,,,,,,,,,,,,1
3,,,,,,,,,,,,,,,,,,,,,,,,,,,,,,,2
1,,,,,,,,,,,,,,,,,,,,,,,,,,,,,,,1
4,,,,,,,,,,,,,,,,,,,,,,,,,,,,,,,2
1,,,,,,,,,,,,,,,,,,,,,,,,,,,,,,,1
2,,,,,,,,,,,,,,,,,,,,,,,,,,,,,,,2
2,,,,,,,,,,,,,,,,,,,,,,,,,,,,,,,1
1,,,,,,,,,,,,,,,,,,,,,,,,,,,,,,,2
2,,,,,,,,,,,,,,,,,,,,,,,,,,,,,,,1
1,,,,,,,,,,,,,,,,,,,,,,,,,,,,,,,2
2,,,,,,,,,,,,,,,,,,,,,,,,,,,,,,,1
1,,,,,,,,,,,,,,,,,,,,,,,,,,,,,,,2
2,,,,,,,,,,,,,,,,,,,,,,,,,,,,,,,1
1,,,,,,,,,,,,,,,,,,,,,,,,,,,,,,,2
2,,,,,,,,,,,,,,,,,,,,,,,,,,,,,,,1
1,,,,,,,,,,,,,,,,,,,,,,,,,,,,,,,1
2,,,,,,,,,,,,,,,,,,,,,,,,,,,,,,,2
1,,,,,,,,,,,,,,,,,,,,,,,,,,,,,,,1
2,,,,,,,,,,,,,,,,,,,,,,,,,,,,,,,2
1,,,,,,,,,,,,,,,,,,,,,,,,,,,,,,,1
2,,,,,,,,,,,,,,,,,,,,,,,,,,,,,,,2
1,,,,,,,,,,,,,,,,,,,,,,,,,,,,,,,1
2,2,1,2,1,2,1,2,1,2,1,2,1,2,1,2,1,2,1,2,1,2,1,2,1,2,1,2,1,2,1,2
